奔驰23款	看车-找车-按其他需求	看车-车型-年代款
起亚kn	看车-品牌-品牌名	看车-其他-看车/其他
别克君威2021款支持无线carplay	用车-故障/维修/保养-故障/维修/保养	看车-车型-年代款
16科沃兹1.5l自动挡	看车-车型-按其他标识	看车-车型-年代款
奔驰合资	其他-新闻/事件-行业热点	看车-找车-按其他需求
大众恩皓	看车-车系-车系名	看车-找车-按其他需求
捷达老款	看车-其他-看车/其他	看车-车系-车系名
几何牛牛	看车-车系-车系名	看车-车型-按其他标识
福田风景g9房车	看车-找车-按特殊种类	看车-车系-车系名
帕萨特22款330什么型号变速箱	用车-故障/维修/保养-故障/维修/保养	看车-其他-看车/其他
东风dxk	看车-车系-车系名	看车-车型-按其他标识
鲁宾汉	看车-车系-车系名	看车-车型-按其他标识
大众迈腾，233900的	看车-找车-按其他需求	看车-车型-按其他标识
哪吒u1098	看车-车型-按其他标识	看车-车系-车系名
2019款长安轻型仓栏式货车	看车-找车-按特殊种类	看车-找车-按其他需求
大陆gt	看车-车系-车系名	看车-车型-按其他标识
哈佛大学	其他-作者/节目/栏目-作者/节目/栏目	其他-未知意图-未知意图
途观l2022款驾驶模式切换	用车-故障/维修/保养-故障/维修/保养	用车-用车教程/百科-教程
奥迪a4新	看车-车系-车系名	看车-车型-按其他标识
丰田for	看车-品牌-品牌名	看车-车系-车系名
19逍客豪华版	看车-车型-按其他标识	看车-车型-年代款
吉利1.5t4缸	看车-车型-按其他标识	看车-找车-动力/能源
北京集团	看车-厂商-厂商名	其他-未知意图-未知意图
保时捷makes	看车-车系-车系名	其他-赛事-赛事
gle进口	看车-车系-车系名	看车-车型-按其他标识
宋plusdm四驱5g	看车-车型-按其他标识	看车-车型-年代款
2017马自达	看车-车型-年代款	看车-找车-按其他需求
本田2022款	看车-车型-年代款	看车-找车-按其他需求
x3尊享怎么没有360	用车-故障/维修/保养-故障/维修/保养	用车-用车教程/百科-教程
奔驰2000	看车-车型-年代款	看车-找车-按其他需求
宝马迷你cooper艺术家	看车-车系-车系名	看车-车型-按其他标识
揽运2022前后大灯原厂和副厂区别	用车-零部件/配件/用品-照明	用车-用车教程/百科-教程
宝奥迪	看车-车系-车系名	看车-品牌-品牌名
新全顺2、0t发动机中轴中顶7座	看车-车型-按其他标识	看车-车型-年代款
大众330suv	看车-车型-按其他标识	看车-找车-按级别
比亚迪创世版	看车-车型-按其他标识	看车-找车-按其他需求
东风闽c2uw07	看车-车系-车系名	其他-未知意图-未知意图
11款凯美瑞高配版	看车-车型-按其他标识	看车-车型-年代款
五菱车	看车-厂商-厂商名	看车-品牌-品牌名
吉利帝豪雷	看车-车型-按其他标识	看车-车系-车系名
昂科威plus第二排空间小	看车-车系-口碑/评价	用车-其他-其他
库里南比	看车-对比-车型对比	看车-车系-车系名
奔驰迈巴克	看车-品牌-品牌名	看车-车系-车系名
五菱之光电瓶车	用车-零部件/配件/用品-其他	看车-车系-车系名
21宽大众id.3	看车-车型-按其他标识	看车-车型-年代款
上海大众g20	看车-车系-车系名	买车-经销商/4S店-经销商/4S店
五菱lzw	看车-车系-车系名	看车-车型-按其他标识
227迈巴赫	看车-车系-车系名	看车-车型-年代款
10、高尔夫1.4t	看车-车型-按其他标识	看车-车型-年代款
cls300coupe	看车-车型-按其他标识	看车-对比-车型对比
老飞度cvt	看车-车型-按其他标识	看车-车型-年代款
奥迪中期改款	其他-新闻/事件-行业热点	看车-车型-按其他标识
电动敞篷	看车-车型-按其他标识	看车-找车-动力/能源
保时捷马肯	看车-品牌-品牌名	看车-车系-车系名
本田幻夜	看车-车系-车系名	看车-车型-按其他标识
亚洲狮22款减配了什么	用车-故障/维修/保养-故障/维修/保养	看车-其他-看车/其他
蒙娜丽莎威尔法	看车-车系-车系名	看车-车型-按其他标识
15xr-v本田	看车-车型-按其他标识	看车-车型-年代款
欧卡黑猫	看车-找车-按特殊种类	看车-车系-车系名
日产风度a31	看车-车系-车系名	看车-车型-按其他标识
凌渡l新款朗逸	看车-对比-车型对比	看车-车型-年代款
900rs	看车-车型-按其他标识	看车-车系-车系名
五菱宏光糯米	看车-车系-车系名	看车-车型-按其他标识
汉dm-i送什么	用车-故障/维修/保养-故障/维修/保养	买车-其他-其他
15别克君威gs	看车-车型-按其他标识	看车-车型-年代款
新老五系	看车-车系-车系名	看车-对比-车型对比
x3宝马19	看车-车型-按其他标识	看车-车型-年代款
大众id.6	看车-车系-车系名	看车-找车-按其他需求
雷克萨斯es300h油电混合2022版	看车-车型-按其他标识	看车-车型-年代款
奔驰两门轿跑	看车-找车-按级别	看车-找车-按其他需求
东风凡尔赛	看车-品牌-品牌名	看车-车系-车系名
2009法拉利加州	看车-车型-年代款	买车-经销商/4S店-经销商/4S店
本田思域2022款口啤	看车-车型-年代款	看车-车系-口碑/评价
2018款比亚迪	看车-车型-年代款	看车-找车-按其他需求
广东吉奥	看车-厂商-厂商名	买车-经销商/4S店-经销商/4S店
本田黑爵士	看车-车系-车系名	看车-车型-按其他标识
福特mahe	看车-品牌-品牌名	看车-车系-车系名
自吸手动挡	看车-车型-按其他标识	看车-找车-按其他需求
吉利帝豪电动车	看车-车型-按其他标识	看车-车系-车系名
大众斯浩	看车-车系-车系名	看车-品牌-品牌名
一汽丰田自动挡	看车-车型-按其他标识	看车-找车-按其他需求
广汽埃安580	看车-车系-车系名	看车-车型-按其他标识
本田思域149990	看车-车型-年代款	看车-车型-按其他标识
x3有35	看车-其他-看车/其他	看车-车型-按其他标识
奥迪a6插电混合	看车-找车-动力/能源	看车-车型-按其他标识
新版福克斯	看车-车型-按其他标识	看车-车系-车系名
…i5	看车-车系-车系名	看车-找车-按其他需求
福特四驱	看车-车型-按其他标识	看车-找车-按其他需求
昂科威s改款2023	看车-车型-年代款	看车-车型-按其他标识
德保帕杰罗	用车-零部件/配件/用品-照明	看车-车系-车系名
嘉华4	看车-车型-按其他标识	看车-车系-车系名
艾瑞泽5p	看车-车型-按其他标识	看车-车系-车系名
奔驰2021年	看车-其他-看车/其他	看车-车型-年代款
新蒙迪欧沃尔沃	看车-车系-车系名	看车-其他-看车/其他
荣威可来	看车-品牌-品牌名	看车-车系-车系名
极光越野	看车-车型-按其他标识	看车-找车-按特殊种类
海马22	看车-车系-车系名	看车-其他-看车/其他
奔腾b70suv	看车-车型-按其他标识	看车-找车-按特殊种类
帕拉梅拉奔驰	看车-车系-车系名	看车-对比-其他
大众天籁	看车-车系-车系名	看车-对比-其他
新款东风风光560	看车-车型-按其他标识	看车-车型-年代款
蒙迪欧开了8年	看车-车型-年代款	买车-二手车-车系二手车
全新大众速腾	看车-车系-车系名	看车-车型-年代款
奔腾r7	看车-车系-车系名	看车-其他-看车/其他
菱智m5	看车-车型-按其他标识	看车-车系-车系名
c200carplay	用车-零部件/配件/用品-其他	用车-用车教程/百科-教程
比亚迪a8	看车-车系-车系名	看车-对比-其他
五菱凯捷vsu	看车-车型-按其他标识	看车-找车-按特殊种类
广汽460	看车-品牌-品牌名	看车-车型-按其他标识
c5l	看车-车系-车系名	其他-未知意图-未知意图
本田cr-v2008	看车-车型-年代款	看车-车型-按其他标识
13年星骋手动	看车-车型-年代款	看车-车系-车系名
rx320荣威18款cvt	看车-车型-按其他标识	看车-车型-年代款
gls奔驰轿跑	看车-车系-车系名	看车-车型-按其他标识
沃尔沃s90亚太	看车-车型-按其他标识	看车-车系-车系名
传旗猛禽	看车-车系-车系名	其他-未知意图-未知意图
宝马gt-r	看车-车系-车系名	看车-车型-按其他标识
汽油车奔奔	看车-车系-车系名	看车-车型-按其他标识
gt6系	看车-车型-按其他标识	看车-车系-车系名
混动雅阁后座拆卸	用车-故障/维修/保养-故障/维修/保养	用车-用车教程/百科-教程
jeep大瓦格纳	看车-车系-车系名	看车-车型-按其他标识
cs75长安2013	看车-车型-年代款	看车-车型-按其他标识
奔驰gle新能源哪种模式最节能	用车-故障/维修/保养-故障/维修/保养	用车-用车教程/百科-教程
哈弗4	看车-车系-车系名	看车-品牌-品牌名
宝马ix35万公里	用车-其他-其他	其他-未知意图-未知意图
宝马4系进口suv	看车-车系-车系名	看车-找车-按特殊种类
奔驰sonny	看车-车系-车系名	其他-未知意图-未知意图
坦途400	看车-车型-按其他标识	其他-未知意图-未知意图
荣威i5,2020款4g互联领豪版中控怎样播放mv	用车-故障/维修/保养-故障/维修/保养	用车-用车教程/百科-教程
路虎8	看车-车系-车系名	其他-未知意图-未知意图
rav4丰田2022款图两驱风尚plus	看车-车型-年代款	看车-车型-按其他标识
id.6	看车-车系-车系名	其他-未知意图-未知意图
路虎星脉2019	看车-车型-年代款	看车-车型-按其他标识
新途达	看车-车系-车系名	看车-车型-年代款
比亚迪新款汉dm	看车-车型-按其他标识	看车-车型-年代款
欧蓝德2022款车型展示在什么地方	看车-其他-看车/其他	其他-未知意图-未知意图
哈佛田园犬	看车-车系-车系名	看车-车型-按其他标识
奔驰vs560	看车-车型-按其他标识	看车-车系-车系名
旧款s4	看车-车系-车系名	看车-车型-按其他标识
道奇srt战斧	看车-车系-车系名	看车-其他-看车/其他
皇冠与宝马	看车-对比-车型对比	看车-对比-其他
e350l插电混合	看车-车型-按其他标识	看车-找车-动力/能源
本田瑞纳	看车-车系-车系名	看车-其他-看车/其他
东风风俊	看车-品牌-品牌名	看车-车系-车系名
凯美瑞2.5g豪华版要怎么验车	其他-政策/法规/流程-政策/法规/流程	用车-用车教程/百科-教程
奔驰angel	看车-品牌-品牌名	看车-其他-看车/其他
19宝马mini	看车-车型-按其他标识	看车-车型-年代款
保时捷帕	看车-品牌-品牌名	看车-车系-车系名
奥迪q8和兰博基尼	看车-对比-车型对比	看车-其他-看车/其他
阿特兹v552	看车-车型-按其他标识	用车-零部件/配件/用品-轮胎/轮毂
卡罗拉双擎混动143800	买车-车价格/优惠-车价格/优惠	看车-车型-按其他标识
30万公里小鹏p7	看车-车系-车系名	看车-其他-看车/其他
斯玛特精灵	看车-车系-车系名	其他-未知意图-未知意图
现代x7	看车-车系-车系名	看车-其他-看车/其他
本田皓影新能源2022	看车-车型-年代款	看车-车型-按其他标识
塞纳混动原理	看车-其他-看车/其他	用车-用车教程/百科-教程
祥菱小卡	看车-车系-车系名	看车-找车-按级别
大众浩	看车-车系-车系名	看车-车型-按其他标识
丰田海拉	用车-零部件/配件/用品-照明	看车-车系-车系名
2011三菱	看车-车型-年代款	看车-找车-按其他需求
大众1.5t	看车-车型-按其他标识	看车-找车-按其他需求
三代h6最适合机油	用车-故障/维修/保养-故障/维修/保养	用车-零部件/配件/用品-其他
福特新时代短轴低顶	看车-车型-按其他标识	看车-找车-按其他需求
现代ix35领先版	看车-车型-年代款	看车-车型-按其他标识
科沃兹isofix	看车-车型-按其他标识	用车-零部件/配件/用品-其他
比亚迪速锐，2014年	看车-车型-年代款	看车-车型-按其他标识
骐达vs5	看车-车系-车系名	看车-对比-车系对比
奔驰74	看车-车系-车系名	看车-品牌-品牌名
伊兰特1238	看车-车型-按其他标识	看车-车系-车系名
大众1.5	看车-车型-按其他标识	看车-找车-按其他需求
东风启辰d60新能源车	看车-车系-车系名	看车-车型-按其他标识
16款glc300豪华	看车-车型-年代款	看车-车型-按其他标识
腾势9	看车-车系-车系名	看车-找车-按其他需求
m8c	看车-车型-按其他标识	看车-车系-车系名
艾维亚电动门	看车-车型-按其他标识	用车-零部件/配件/用品-其他
欧尚x	看车-车系-车系名	看车-找车-按其他需求
丰田双擎	看车-车型-按其他标识	看车-找车-按其他需求
比迪亚宋dm-i	看车-车系-车系名	看车-车型-按其他标识
ct4鹿头	看车-车型-按其他标识	用车-改装/美容-改装/美容
奔驰c房车	看车-找车-按特殊种类	看车-找车-按其他需求
宾利w12	看车-车型-按其他标识	看车-找车-按其他需求
大众迷你搂搂	看车-车系-车系名	看车-其他-看车/其他
g500和个350	看车-对比-车型对比	看车-对比-车系对比
福特世纪	看车-车系-车系名	看车-其他-看车/其他
20荣放威兰达	看车-车型-按其他标识	看车-对比-车型对比
飞驰轿跑	看车-车型-按其他标识	看车-车系-车系名
911tu	看车-车型-按其他标识	看车-其他-看车/其他
长安plus	看车-车系-车系名	看车-找车-按其他需求
艾维亚6座	看车-车型-按其他标识	看车-找车-按车身结构
雅阁8	看车-车系-车系名	看车-车型-年代款
宝马21款	看车-车型-年代款	看车-找车-按其他需求
奔马迷你	看车-车系-车系名	看车-其他-看车/其他
奔驰迈巴赫s400	看车-车型-按其他标识	看车-对比-车系对比
劳斯莱斯黎明	看车-车系-车系名	看车-找车-按其他需求
2022丰田威兰达	看车-车型-年代款	看车-车型-按其他标识
领克插混	看车-找车-动力/能源	看车-找车-按车身结构
福特全顺新世代7座	看车-车型-年代款	看车-车型-按其他标识
targa顶篷	看车-车型-按其他标识	看车-其他-看车/其他
16款朗动系统升级包	用车-零部件/配件/用品-其他	用车-其他-其他
byd明	看车-品牌-品牌名	看车-车系-车系名
90年代本田	看车-找车-按其他需求	看车-其他-看车/其他
e200进口	看车-车系-车系名	看车-车型-按其他标识
比亚迪f8	看车-车系-车系名	看车-其他-看车/其他
14年320gt	看车-车型-年代款	看车-其他-看车/其他
标致9x8	看车-车型-按其他标识	看车-车系-车系名
gls500迈巴赫	看车-车型-按其他标识	看车-对比-车系对比
长城哈弗m6plus	看车-车系-车系名	看车-车型-按其他标识
2021款哪吒pro新能源电动汽车	看车-车型-年代款	看车-找车-动力/能源
新能源长安新欧尚z6	看车-车系-车系名	看车-车型-按其他标识
2004年丰田suv	看车-车型-年代款	看车-找车-按级别
cls6308	看车-车型-按其他标识	看车-车型-年代款
